R 800 800
NO ./textures/metal.xpm
SO ./textures/rainbow.xpm
WE ./textures/tiger.xpm
EA ./textures/wall.xpm
S ./textures/cactus.xpm
C 167500
F 167500
11111111
12000001
100N0001
10000021
11111111