R 600 400
NO ./textures/metal.xpm
SO ./textures/rainbow.xpm
WE ./textures/tiger.xpm
EA ./textures/wall.xpm
S ./textures/cactus.xpm
C 16747640
F 16737400
1111111
1000001
1S22001
1000001
1111111