R 800 800
NO ./textures/metal.xpm
SO ./textures/wall.xpm
WE ./textures/stone.xpm
EA ./textures/rainbow.xpm
S ./textures/cactus.xpm
C 010,150,000
F 255,20,100
   11111111111
11121000011
 1000000011111
1000000111
10002N00011
10000000011
11111111111