R 800 800
NO ./textures/metal.xpm
SO ./textures/rainbow.xpm
WE ./textures/tiger.xpm
EA ./textures/wall.xpm
S ./textures/cactus.xpm
C 16750
F 167500
1111111
1000001
1S22001
1000001
1111111